000000000000000000000000000000000000000000000000000000000000000000000000000000000000000000000000000000
000000000000000000000000000000000000000000000000000000000000000000000000000000000000000000000000000000
000000000000000000000000000000000000000011111111000000000011111100000000000000000000000000000000000000
000000000000000000000000000000000000000011111111000000000011111100000000000000000000000000000000000000
000000000000000000000000000000000000111111111111110000001111111111111111000000000000000000000000000000
000000000000000000000000000000000000111111111111110000001111111111111111000000000000000000000000000000
000000000000000000000000001111111111111111111111111111111111111111111111111111000000000000000000000000
000000000000000000000000001111111111111111111111111111111111111111111111111111000000000000000000000000
000000000000000000001111111111111111111111111111111111111111111111111111111111111100000000000000000000
000000000000000000001111111111111111111111111111111111111111111111111111111111111100000000000000000000
000000000000000000111111111111111111111111111111111111111111111111111111111111111111110000000000000000
000000000000000000111111111111111111111111111111111111111111111111111111111111111111110000000000000000
000000000000000011111111111111111111111111111111111111111111111111111111111111111111111100000000000000
000000000000000011111111111111111111111111111111111111111111111111111111111111111111111100000000000000
000000000000001111111111111111111111111111111111111111111111111111111111111111111111111100000000000000
000000000000001111111111111111111111111111111111111111111111111111111111111111111111111100000000000000
000000000000111111111111111111111111111111111111111111111111111111111111111111111111111111000000000000
000000000000111111111111111111111111111111111111111111111111111111111111111111111111111111000000000000
000000000011111111111111111111111111111111111111111111111111111111111111111111111111111111000000000000
000000000011111111111111111111111111111111111111111111111111111111111111111111111111111111000000000000
000000000011111111111111111111111111111111111111111111111111111111111111111111111111111111110000000000
000000000011111111111111111111111111111111111111111111111111111111111111111111111111111111110000000000
000000000011111111111111111111111111111111111111111111111111111111111111111111111111111111110000000000
000000000011111111111111111111111111111111111111111111111111111111111111111111111111111111110000000000
000000000011111111111111111111111111111111111111111111111111111111111111111111111111111111110000000000
000000000011111111111111111111111111111111111111111111111111111111111111111111111111111111110000000000
000000000011111111111111111111111111111111111111111111111111111111111111111111111111111111111100000000
000000000011111111111111111111111111111111111111111111111111111111111111111111111111111111111100000000
000000111111111111111111111111111111111111111111111111111111111111111111111111111111111111111111000000
000000111111111111111111111111111111111111111111111111111111111111111111111111111111111111111111000000
000000111111111111111111111111111111111111111111111111111111111111111111111111111111111111111111000000
000000111111111111111111111111111111111111111111111111111111111111111111111111111111111111111111000000
000011111111111111111111111111111111111111111111111111111111111111111111111111111111111111000000000000
000011111111111111111111111111111111111111111111111111111111111111111111111111111111111111000000000000
001111111111111111111111111111111111110000000000001111111111111111111111111111111111110000000000000000
001111111111111111111111111111111111110000000000001111111111111111111111111111111111110000000000000000
001111111111111111111111111111111111000000000000000000001111110000000000000011111111000000000000000000
001111111111111111111111111111111111000000000000000000001111110000000000000011111111000000000000000000
001111111111111111111111111111111111000000000000000000000000000000000000000000111100000000000000000000
001111111111111111111111111111111111000000000000000000000000000000000000000000111100000000000000000000
001111111111111111111111111111111111111100001111110000000000000000000000000000111100000000000000000000
001111111111111111111111111111111111111100001111110000000000000000000000000000111100000000000000000000
000011111111111111111111111111111111111111111111111111000000000000001111111111110000000000000000000000
000011111111111111111111111111111111111111111111111111000000000000001111111111110000000000000000000000
000011111111111111111111111111111111111111111111111111110000000000111111111111110000000000001111110000
000011111111111111111111111111111111111111111111111111110000000000111111111111110000000000001111110000
000011111111111111111111111111111111111111111111111111110000000000001111111111111100000000001111110000
000011111111111111111111111111111111111111111111111111110000000000001111111111111100000000001111110000
000000111111111111111111111111111111111111111111111111000011110000000000000000000000000000001111110000
000000111111111111111111111111111111111111111111111111000011110000000000000000000000000000001111110000
000000111111111111111111111111111111111111111111111100001111110000000000000000000000000000000011000000
000000111111111111111111111111111111111111111111111100001111110000000000000000000000000000000011000000
000011111111111111111111111111111111111111111111110000111111111100000000000000000000000000000011000000
000011111111111111111111111111111111111111111111110000111111111100000000000000000000000000000011000000
000000111111111111111111111111111111111111111111111111111111111111000000000000000000000000000011000000
000000111111111111111111111111111111111111111111111111111111111111000000000000000000000000000011000000
000000111111111111111111111111111111111111111111000011111111111111000000000000000000000000000011110000
000000111111111111111111111111111111111111111111000011111111111111000000000000000000000000000011110000
000000001111111111111111111111111111110000000000001111111111111111000000001111111111111111111111111100
000000001111111111111111111111111111110000000000001111111111111111000000001111111111111111111111111100
000000001111111111111111111111110000000000000000001111111111111111000000001111111111111111111111111100
000000001111111111111111111111110000000000000000001111111111111111000000001111111111111111111111111100
000000000011111111111111111111000000000000000000001111111111111111000000111111111111111111111111111100
000000000011111111111111111111000000000000000000001111111111111111000000111111111111111111111111111100
000000000011111111111111111100000000000000000000000011111111111111000000001111111111111111111111110000
000000000011111111111111111100000000000000000000000011111111111111000000001111111111111111111111110000
000000000000111111111111111100000000000000000000000011111111111111000000001111111111111111111111000000
000000000000111111111111111100000000000000000000000011111111111111000000001111111111111111111111000000
000000000000001111111111111100000000000000000000000011111111111111000000001111111111111111111100000000
000000000000001111111111111100000000000000000000000011111111111111000000001111111111111111111100000000
000000000000000011111111111111000000000000000000000011111111111111000000000011110000000000000000000000
000000000000000011111111111111000000000000000000000011111111111111000000000011110000000000000000000000
000000000000000000111111111111110000000000000000001111111111111111000000000000000000000000000000000000
000000000000000000111111111111110000000000000000001111111111111111000000000000000000000000000000000000
000000000000000000001111111111111100000000000000001111111111111100000000000000000000000000000000000000
000000000000000000001111111111111100000000000000001111111111111100000000000000000000000000000000000000
000000000000000000000011111111111111000000000011111111111111110000000000000000000000000000000000000000
000000000000000000000011111111111111000000000011111111111111110000000000000000000000000000000000000000
000000000000000000000000000011111111000000111111111111111111000000000000000000000000000000000000000000
000000000000000000000000000011111111000000111111111111111111000000000000000000000000000000000000000000
000000000000000000000000000000000000000011111111111111111100000000000000000000000000000000000000000000
000000000000000000000000000000000000000011111111111111111100000000000000000000000000000000000000000000
000000000000000000000000000000000000000000111111111111110000000000000000000000000000000000000000000000
000000000000000000000000000000000000000000111111111111110000000000000000000000000000000000000000000000
000000000000000000000000000000000000000000000000000000000000000000000000000000000000000000000000000000
000000000000000000000000000000000000000000000000000000000000000000000000000000000000000000000000000000