000000000000000000000000000000000000000000000000000000000000000000000000000
000000000000000000000000000000000000000000000000000000000000000000000000000
000000000000000000000000000000000000000000000000000000000000000000000000000
000000000000000000000000000000000000000000000000000000000000000000000000000
000000000000000000000000000000000000000000000000000000000000000000000000000
000000000000000000000000000000000000000000000000000000000000000000000000000
000000000000000000000000000000002222000002220000000000000000000000000000000
000000000000000000000000000000222222200022222222000000000000000000000000000
000000000000000000000000011111111112222222222222222000000000000000000000000
000000000000000000000022222111111111222222222222222220000000000000000000000
000000000000000000000222222211111111111222222222222222200000000000000000000
000000000000000000002222222111111111111112222222222222220000000000000000000
000000000000000000022222211100111111111111222222222222220000000000000000000
000000000000000000222222221111111111111111222222222222222000000000000000000
000000000000000002222222221111111111111111112222222222222000000000000000000
000000000000000002222222211111111122221111111122222222222200000000000000000
000000000000000002222222111111222222222111111111222222222200000000000000000
000000000000000002222211111112222222222221111113333322222200000000000000000
000000000000000003322111111122222222222222111133333333322220000000000000000
000000000000000333333111112222222222222222111333333333332222000000000000000
000000000000000333333111122222220222222222222333333333333222000000000000000
000000000000003333333111222222222222222222222233333333333000000000000000000
000000000000033333333111222222200000022222222222233333300000000000000000000
000000000000033333331111122222000000000022200000003333000000000000000000000
000000000000033333331111112222000000000000000000000330000000000000000000000
000000000000033333311111122222220022200000000000000330000000000000000000000
000000000000003333311111122222222222222000002222233300000000000000000000000
000000000000003333331111111222222222222200022222223300000022200000000000000
000000000000003333331111111122222222222200002222222330000020200000000000000
000000000000000333333111111111222222222002200222222233000022200000000000000
000000000000000333322222111111111222220022200022222233300002000000000000000
000000000000002233222112211111111111100222220022222233330001000000000000000
000000000000000222221111221111111111111112222002223333330001000000000000000
000000000000000222211111222211111111001111222000333333333221100000000000000
000000000000000022211112222222100000011111122000033333332222110000000000000
000000000000000022221122222200000000011111111000033333322021110000000000000
000000000000000002222222222000000110011111111000333333222211110000000000000
000000000000000002222222220000002201001110011000033333222111100000000000000
000000000000000000222222220000002201001110011000033333311111000000000000000
000000000000000000022222220000000222001111111000033333333110000000000000000
000000000000000000002222222000000000001111111000003300000000000000000000000
000000000000000000000222222200000000011111122000000000000000000000000000000
000000000000000000000022222220000000011112220000000000000000000000000000000
000000000000000000000002222202000001111122200000000000000000000000000000000
000000000000000000000000002222000111112222000000000000000000000000000000000
000000000000000000000000000000002222222220000000000000000000000000000000000
000000000000000000000000000000000222222200000000000000000000000000000000000
000000000000000000000000000000000000000000000000000000000000000000000000000
000000000000000000000000000000000000000000000000000000000000000000000000000
000000000000000000000000000000000000000000000000000000000000000000000000000
000000000000000000000000000000000000000000000000000000000000000000000000000
000000000000000000000000000000000000000000000000000000000000000000000000000
000000000000000000000000000000000000000000000000000000000000000000000000000