000000000000000000000000000000000000000000000000000
000000000000000000002222000002220000000000000000000
000000000000000000222222200022222222000000000000000
000000000000011111111112222222222222222000000000000
000000000022222111111111222222222222222220000000000
000000000222222211111111111222222222222222200000000
000000002222222111111111111112222222222222220000000
000000022222211100111111111111222222222222220000000
000000222222221111111111111111222222222222222000000
000002222222221111111111111111112222222222222000000
000002222222211111111122221111111122222222222200000
000002222222111111222222222111111111222222222200000
000002222211111112222222222221111113333322222200000
000003322111111122222222222222111133333333322220000
000333333111112222222222222222111333333333332222000
000333333111122222220222222222222333333333333222000
003333333111222222222222222222222233333333333000000
033333333111222222200000022222222222233333300000000
033333331111122222000000000022200000003333000000000
033333331111112222000000000000000000000330000000000
033333311111122222220022200000000000000330000000000
003333311111122222222222222000002222233300000000000
003333331111111222222222222200022222223300000022200
003333331111111122222222222200002222222330000020200
000333333111111111222222222002200222222233000022200
000333322222111111111222220022200022222233300002000
002233222112211111111111100222220022222233330001000
000222221111221111111111111112222002223333330001000
000222211111222211111111001111222000333333333221100
000022211112222222100000011111122000033333332222110
000022221122222200000000011111111000033333322021110
000002222222222000000110011111111000333333222211110
000002222222220000002201001110011000033333222111100
000000222222220000002201001110011000033333311111000
000000022222220000000222001111111000033333333110000
000000002222222000000000001111111000003300000000000
000000000222222200000000011111122000000000000000000
000000000022222220000000011112220000000000000000000
000000000002222202000001111122200000000000000000000
000000000000002222000111112222000000000000000000000
000000000000000000002222222220000000000000000000000
000000000000000000000222222200000000000000000000000
000000000000000000000000000000000000000000000000000