000000000000000000000000000000000000000000000000000
000000000000000000002222000002220000000000000000000
000000000000000000222222200022222222000000000000000
000000000000011111111112222222222222222000000000000
000000000011111111111111222222222222222220000000000
000000000111111111111111111222222222222222200000000
000000001111111111111111111112222222222222220000000
000000011111111100111111111111222222222222220000000
000000111111111111111111111111222222222222222000000
000001111111111111111111111111112222222222222000000
000001111111111111111111111111111122222222222200000
000001111111111111111111111111111111222222222200000
000001111111111111111111111111111112222222222200000
000001111111111111111111111111111122222222222220000
000111111111111111111111111111111222222222222222000
000111111111111111110111111111222222222222222222000
001111111111111111111111111112222222222222222000000
011111111111111111100000011222222222222222200000000
011111111111111111000000000022200000002222000000000
011111111111111111000000000000000000000220000000000
011111111111111111110011100000000000000220000000000
001111111111111111111111111000003333333300000000000
001111111111111111111111111100033333333300000044400
001111111111111111111111111100003333333330000040400
000111111111111111111111111000000333333333000044400
000111111111111111111111110000000033333333300004000
001111111111111111111111100000000033333333330004000
000111111111111111111111100000000003333333330004000
000111111111111111111111000000000000333333333444400
000011111111111111100000000000000000033333334444440
000011111111111100000000000000000000033333344044440
000001111111111000000110000000000000333333444444440
000001111111110000001101000000000000033333444444400
000000111111110000001101000000000000033333344444000
000000011111110000000111000000000000033333333440000
000000001111111000000000000000000000003300000000000
000000000111111100000000000000000000000000000000000
000000000011111110000000000000000000000000000000000
000000000001111101000000000000000000000000000000000
000000000000001111000000000000000000000000000000000
000000000000000000000000000000000000000000000000000
000000000000000000000000000000000000000000000000000
000000000000000000000000000000000000000000000000000