000000000000000000000000000000000000000000000000000
000000000000000000002222000002220000000000000000000
000000000000000000222222200022222222000000000000000
000000000000011111111112222222222222222000000000000
000000000011111111111111222222222222222220000000000
000000000111111111111111111222222222222222200000000
000000001111111111111111111112222222222222220000000
000000011111111100111111111111222222222222220000000
000000111111111111111111111111222222222222222000000
000001111111111111111111111111112222222222222000000
000001111111111111111111111111111122222222222200000
000001111111111111111111111111111111222222222200000
000001111111111111111111111111111112222222222200000
000001111111111111111111111111111122222222222220000
000111111111111111111111111111111222222222222222000
000111111111111111110111111111222222222222222222000
001111111111111111111111111112222222222222222000000
011111111111111111100000011222222222222222200000000
011111111111111111000000000022200000002222000000000
011111111111111111000000000000000000000220000000000
011111111111111111110011100000000000000220000000000
001111111111111111111111111000002222222200000000000
001111111111111111111111111100022222222200000033300
001111111111111111111111111100002222222220000030300
000111111111111111111111111000000222222222000033300
000111111111111111111111110000000022222222200003000
001111111111111111111111100000000022222222220003000
000111111111111111111111100000000002222222220003000
000111111111111111111111000000000000222222222333300
000011111111111111100000000000000000022222223333330
000011111111111100000000000000000000022222233033330
000001111111111000000110000000000000222222333333330
000001111111110000001101000000000000022222333333300
000000111111110000001101000000000000022222233333000
000000011111110000000111000000000000022222222330000
000000001111111000000000000000000000002200000000000
000000000111111100000000000000000000000000000000000
000000000011111110000000000000000000000000000000000
000000000001111101000000000000000000000000000000000
000000000000001111000000000000000000000000000000000
000000000000000000000000000000000000000000000000000
000000000000000000000000000000000000000000000000000
000000000000000000000000000000000000000000000000000