000000000000000000000000000000000000000000000000000
000000000000000000001111000001110000000000000000000
000000000000000000111111100011111111000000000000000
000000000000000000000001111111111111111000000000000
000000000000000000000000111111111111111110000000000
000000000000000000000000000111111111111111100000000
000000000000000000000000000001111111111111110000000
000000000000000000000000000000111111111111110000000
000000000000000000000000000000111111111111111000000
000000000000000000000000000000001111111111111000000
000000000000000000000000000000000011111111111100000
000000000000000000000000000000000000111111111100000
000000000000000000000000000000000001111111111100000
000000000000000000000000000000000011111111111110000
000000000000000000000000000000000111111111111111000
000000000000000000000000000000000111111111111111000
000000000000000000000000000000000011111111111000000
000000000000000000000000000000000000011111100000000
000000000000000000000000000000000000001111000000000
000000000000000000000000000000000000000110000000000
000000000000000000000000000000000000000110000000000
000000000000000000000000000000002222222200000000000
000000000000000000000000000000022222222200000022200
000000000000000000000000000000002222222220000020200
000000000000000000000000000000000222222222000022200
000000000000000000000000000000000022222222200002000
000000000000000000000000000000000022222222220002000
000000000000000000000000000000000002222222220002000
000000000000000000000000000000000000222222222222200
000000000000000000000000000000000000022222222222220
000000000000000000000000000000000000022222222022220
000000000000000000000000000000000000222222222222220
000000000000000000000000000000000000022222222222200
000000000000000000000000000000000000022222222222000
000000000000000000000000000000000000022222222220000
000000000000000000000000000000000000002200000000000
000000000000000000000000000000000000000000000000000
000000000000000000000000000000000000000000000000000
000000000000000000000000000000000000000000000000000
000000000000000000000000000000000000000000000000000
000000000000000000000000000000000000000000000000000
000000000000000000000000000000000000000000000000000
000000000000000000000000000000000000000000000000000