000000000000000000000000000000000000000000000000000000000000000000000000000
000000000000000000000000000000000000000000000000000000000000000000000000000
000000000000000000000000000000000000000000000000000000000000000000000000000
000000000000000000000000000000000000000000000000000000000000000000000000000
000000000000000000000000000000000000000000000000000000000000000000000000000
000000000000000000000000000000000000000000000000000000000000000000000000000
000000000000000000000000000000001111000001110000000000000000000000000000000
000000000000000000000000000000111111100011111111000000000000000000000000000
000000000000000000000000000000000001111111111111111000000000000000000000000
000000000000000000000000000000000000111111111111111110000000000000000000000
000000000000000000000000000000000000000111111111111111100000000000000000000
000000000000000000000000000000000000000001111111111111110000000000000000000
000000000000000000000000000000000000000000111111111111110000000000000000000
000000000000000000000000000000000000000000111111111111111000000000000000000
000000000000000000000000000000000000000000001111111111111000000000000000000
000000000000000000000000000000000000000000000011111111111100000000000000000
000000000000000000000000000000000000000000000000111111111100000000000000000
000000000000000000000000000000000000000000000001111111111100000000000000000
000000000000000000000000000000000000000000000011111111111110000000000000000
000000000000000000000000000000000000000000000111111111111111000000000000000
000000000000000000000000000000000000000000000111111111111111000000000000000
000000000000000000000000000000000000000000000011111111111000000000000000000
000000000000000000000000000000000000000000000000011111100000000000000000000
000000000000000000000000000000000000000000000000001111000000000000000000000
000000000000000000000000000000000000000000000000000110000000000000000000000
000000000000000000000000000000000000000000000000000110000000000000000000000
000000000000000000000000000000000000000000002222222200000000000000000000000
000000000000000000000000000000000000000000022222222200000022200000000000000
000000000000000000000000000000000000000000002222222220000020200000000000000
000000000000000000000000000000000000000000000222222222000022200000000000000
000000000000000000000000000000000000000000000022222222200002000000000000000
000000000000000000000000000000000000000000000022222222220002000000000000000
000000000000000000000000000000000000000000000002222222220002000000000000000
000000000000000000000000000000000000000000000000222222222222200000000000000
000000000000000000000000000000000000000000000000022222222222220000000000000
000000000000000000000000000000000000000000000000022222222022220000000000000
000000000000000000000000000000000000000000000000222222222222220000000000000
000000000000000000000000000000000000000000000000022222222222200000000000000
000000000000000000000000000000000000000000000000022222222222000000000000000
000000000000000000000000000000000000000000000000022222222220000000000000000
000000000000000000000000000000000000000000000000002200000000000000000000000
000000000000000000000000000000000000000000000000000000000000000000000000000
000000000000000000000000000000000000000000000000000000000000000000000000000
000000000000000000000000000000000000000000000000000000000000000000000000000
000000000000000000000000000000000000000000000000000000000000000000000000000
000000000000000000000000000000000000000000000000000000000000000000000000000
000000000000000000000000000000000000000000000000000000000000000000000000000
000000000000000000000000000000000000000000000000000000000000000000000000000
000000000000000000000000000000000000000000000000000000000000000000000000000
000000000000000000000000000000000000000000000000000000000000000000000000000
000000000000000000000000000000000000000000000000000000000000000000000000000
000000000000000000000000000000000000000000000000000000000000000000000000000
000000000000000000000000000000000000000000000000000000000000000000000000000