100000000000000000000000000000000
100000000000000000000000000000000
100000000000000111100000000000000
100000000000000111100000000000000
100000110000000111100000000000000
100000110000000111100000000111000
101111110000000011000000001111100
101111110000000011000000001111100
101101110000000011000000001111100
101111110000000011000000001111100
101111110000000011000000001111100
100110000000000011000000000010000
101110000000000011000000000010000
101110000000000011000000000010000
101110000000000011000000000010000
101111110000000011000000000111000
101111110000000011000000001111100
100011000000000011000000001111110
101111110000000011000000001111110
101111111111111111111111111111110
101111111000001111111111111111110
101111111000001111111111111111110
100011011000001011011111111111110
100011001111110011000111111000000
111111111111111111111111111011100
111111111111111111111111111011100
100011111111111111111111111001000
100011111110001111111111111111110
100001111110001011111111111111110
100001001110001011100000111111110
100001001110001001100000111111110
100001000110111101100000111001000
101001000110111101101110111011100
101011110110111101001111111010100
101011110110000001001110011011100
101011110111111111000000111000000
101000000111111100001111111111110
101111111111111111111111011011110
100000000000000000000000011000000
111111111111111111111111111111111