000000000000000000000000000000000000000000000000000
000000000000000000001111000001110000000000000000000
000000000000000000111111100011111111000000000000000
000000000000011111111111111111111111111000000000000
000000000011111111111111111111111111111110000000000
000000000111111111111111111111111111111111100000000
000000001111111111111111111111111111111111110000000
000000011111111111111111111111111111111111110000000
000000111111111111111111111111111111111111111000000
000001111111111111111111111111111111111111111000000
000001111111111111111111111111111111111111111100000
000001111111111111111111111111111111111111111100000
000001111111111111111111111111111111111111111100000
000001111111111111111111111111111111111111111110000
000111111111111111111111111111111111111111111111000
000111111111111111111111111111111111111111111111000
001111111111111111111111111111111111111111111000000
011111111111111111100000011111111111111111100000000
011111111111111111000000000011100000001111000000000
011111111111111111000000000000000000000110000000000
011111111111111111110011100000000000000110000000000
001111111111111111111111111000001111111100000000000
001111111111111111111111111100011111111100000011100
001111111111111111111111111100001111111110000010100
000111111111111111111111111001100111111111000011100
000111111111111111111111110011100011111111100001000
001111111111111111111111100111110011111111110001000
000111111111111111111111111111111001111111110001000
000111111111111111111111001111111000111111111111100
000011111111111111100000011111111000011111111111110
000011111111111100000000011111111000011111111111110
000001111111111000000110011111111000111111111111110
000001111111110000001111001111111000011111111111100
000000111111110000001111001111111000011111111111000
000000011111110000000111001111111000011111111110000
000000001111111000000000001111111000001100000000000
000000000111111100000000011111111000000000000000000
000000000011111110000000011111110000000000000000000
000000000001111111000001111111100000000000000000000
000000000000001111000111111111000000000000000000000
000000000000000000001111111110000000000000000000000
000000000000000000000111111100000000000000000000000
000000000000000000000000000000000000000000000000000